 1  1  1  1  1  1  1  1 51  1  1  1  1  1  1  1  1  1  1  1  1  1  1  1  1 
 1  1  1  1  1  1  1  1  9  1  1  1  1  1  1 11  1  1 11  1  1  1  1  1  1 
 1  1  7 92  7  1  1  1  1  1  2  2 95 95  4  4  4  4  4  4 15  1  1  1  1 
 1  1  7  7  7  1  1 94 94  1  2  2  2  2  4  4 97  4 97  4 85  1  1  1  1 
 1  1  1  1  1  1  1  1  1  1 17  2  2  2 93  4  4  4  4  4  3  1  1  1  1 
 1  1  1  1  1 86  1  8 99  8  1  1  1  1  1  1  1  1  1  1  1  1  1  1  1 
 1  1  1  1 84  1  1 16  8 14  1  1  1  1  1  1  1  1  1  1  2 13  1  1  1 
 1  1  1  2  2  2  2  1  8  1 85  3  1  1  1  1  1  1  1  1  2  2  1 51  1 
 1  1  1  2  2 95  2  1  8  1  3  3  1  1  1  1  1  1  1  1  2 12  1  1  1 
 1  1  1  1  1  1  1  1  8  1 87  3  1  1  1  1  1  1  1  1  1  1  1  1  1 
 1  1  5 19 19  5  1  1  8  1  1  1  1  1  1  1  1  1  1  8 90  1  1  1  1 
 1  1  5  5  5 18  1  1  8  1 84  1  1  1  1  1  1  1 98  8  8  1  1  1  1 
 1  1 96  5  5  5  1  1  1  1  1  1  1  1  1  1 83 83  1  8 14  1  1  1  1 
 1  1 89  5  5  5  1  1  1  1  1  1  1  1  1  1  1  1  1  1  1  1  1  1  1 
 1  1  1 10 10  1  1  1  1  1  1  1  1  1  1  1  1  1  1  1  1  1  1  1  1 
 1  1  1 51  1  1  1  1  1  1  1  1  1  1  1  1  1  1  1  1  1  1  1  1  1 
 1  1  1  1  1  1  1  1  1  1  1  1  1  1  1  1  1  1  1  1  1  1  1  1  1 
