50 50 50 50 50 50 50 50 51 50 50 50 50 50 50 50 50 50 50 50 50 50 50 50 50 
50 50 50 50 50 50 50 50  9 50 50 50 50 50 50 11 50 50 11 50 50 50 50 50 50 
50 50  7 92  7  1  0  0  0  0  2  2 95 95  4  4  4  4  4  4 15 50 50 50 50 
50 50  7  7  7  6  0 94 94  0  2  2  2  2  4  4 97  4 97  4 85 50 50 50 50 
50 50  1  6  6  6  6  6  6  6 17  2  2  2 93  4  4  4  4  4  3 50 50 50 50 
50 50  1  6  0 86  6  8 99  8  6  6  1  1  6  6  1  1  6  6  6 50 50 50 50 
50 50  1  6 84  0  6 16  8 14  6  6  1  1  1  1  1  1  6  6  2 13 50 50 50 
50 50  1  2  2  2  2  6  8  6 85  3  1  1  1  1  1  1  1  1  2  2 50 51 50 
50 50  1  2  2 95  2  6  8  6  3  3  1  1  1  1  1  1  6  6  2 12 50 50 50 
50 50  1  6  6  6  6  6  8  6 87  3  6  1  6  6  1  1  6  6  6 50 50 50 50 
50 50  5 19 19  5  6  6  8  6  6  6  6  1  6  0  0  0  0  8 90 50 50 50 50 
50 50  5  5  5 18  6  6  8  6 84  0  6  1  6  0  0  0 98  8  8 50 50 50 50 
50 50 96  5  5  5  1  1  1  1  1  1  1  1  6  0 83 83  0  8 14 50 50 50 50 
50 50 89  5  5  5 50 50 50 50 50 50 50 50 50 50 50 50 50 50 50 50 50 50 50 
50 50 50 10 10 50 50 50 50 50 50 50 50 50 50 50 50 50 50 50 50 50 50 50 50 
50 50 50 51 50 50 50 50 50 50 50 50 50 50 50 50 50 50 50 50 50 50 50 50 50 
50 50 50 50 50 50 50 50 50 50 50 50 50 50 50 50 50 50 50 50 50 50 50 50 50 
-1 -1 -1 -1 -1 -1 -1 -1 -1 -1 -1 -1 -1 -1 -1 -1 -1 -1 -1 -1 -1 -1 -1 -1 -1 
