50 50 50 50 50 50 50 50 50 50 50 51  9 50 50 51 11 50 50 51 51 51 51 51 51 51 51 50 
50  8 99  8 50 50 50 50 92  1  1  1  0  0  0  4  4  4 50 50 50 50 50 50 50 50 50 50 
50 11  8 14 50 50 50 50 50 50 50 50 50 50 50  4  4 97 50 50 50 50 50 50 50 50 51 50 
50 50  8 50 50 50  8  8  8  8  8  8  8 50 50  4  4  4 50 50 50 50 50 50 50 50 50 50 
 6  6  8  6  6  6  8  6  8  8  6  6  3 85  6  2  2  2  3 15 50 50 50 50 50 50 51 51 
 6  6  8  6  6  6  8  6  6  6  6  6  3 87  6  2  2  2  3  3 50 50 50 50 50 50 50 51 
 6  6  8  6  6  6  8  6  6  6 93  4  4  6  6  2  2  2  3  3 50 50 50 50 50 50 50 51 
 6  6  8  6  6  6  8  6  0  6  4  4  4  6  6  6  1  1  6  6 50 50 50 50 50 51 50 51 
 6  6  8  6  8 87  3  6  0  6  6  1  1  1  1  1  1  1  6  6  2 13 50 50 50 50 51 51 
 6 89  5  5  1  1  1  1  1  w  w  1  1  1  1  1  1  1  1  1  2  2 50 50 50 51 50 51 
 6 96  5  5  6  2  2  2  6  6  6  1  1  1  1  1  1  1  6  6  2 12 50 50 50 50 50 51 
50 50 10 50 50  2  2  2  6  6  5  5  5  6  6  0  0  0  6  6 50 50 50 50 50 50 51 51 
50 50 50 50 50  6 84  0  6  6  5  5  5  8  8  0  0  0 90  8 50 50 50 50 50 50 50 51 
50 50 50 50 50  6 86  0  6  6  6  6  6  6  6 94  0 98 95  2 50 50 50 50 50 50 50 51 
51 50 50 50 50  6  6  4  4  4  4  4  4  4  4  0 83  0  2 12 50 50 50 50 50 50 50 51 
51 51 50 50 50 50 50 50 50 50 50 51 51 51 51 51 51 51 51 51 51 51 51 51 51 51 51 51 
51 51 51 51 51 51 51 51 51 51 51 51 51 51 51 51 51 51 51 51 51 51 51 51 51 51 51 51 
                            
